{
  "0": "blank",
  "1": "ㅇ",
  "2": "ㅏ",
  "3": "ㄴ",
  "4": "ㅕ",
  "5": "ㅎ",
  "6": "ㅅ",
  "7": "ㅔ",
  "8": "ㅛ",
  "9": "ㅈ",
  "10": "ㅣ",
  "11": "ㄹ",
  "12": "ㅡ",
  "13": "ㅁ",
  "14": "ㅂ",
  "15": "ㄱ",
  "16": "ㅜ",
  "17": "ㄷ",
  "18": "ㅓ",
  "19": "ㅊ",
  "20": "ㅠ",
  "21": "ㅍ",
  "22": "ㅋ",
  "23": "ㅌ",
  "24": "ㅐ",
  "25": "ㅑ",
  "26": "ㅗ",
  "27": "ㅒ",
  "28": "ㅖ",
  "29": "ㅃ",
  "30": "ㄲ",
  "31": "ㄸ",
  "32": "ㅉ",
  "33": "ㅆ"
}
